69 42
               ######################################################
               #....................................................#
               #.@..................................................#
               #....................................................#
               #....................................................#
               #....................................................#
               #....................................................#
               #....................................................#
               #....................................................#
               ######################################################